11	0	5120	5120	5120
12	5120	5120	5120	5120
75	0	2560	2560	2560
76	2560	2560	2560	2560
587	0	1280	1280	1280
588	1280	1280	1280	1280
4683	0	640	640	640
4684	640	640	640	640
4681	0	0	640	640	0	1	20	24	25	26	27	28	29	30	31	32	33	34	38	158	159	198	199	323	364	365
4682	640	0	640	640	0	1	2	3	4	5	6	7	8	9	13	20	21	22	35	36	37	38	39	40	41	42	43	44	45	46	47	48	49	50	51	52	53	54	55	56	57	58	59	60	61	62	63	64	65	159	160	161	162	163	200	201	202	203	204	205	206	207	280	281	322	324	325	326	327	354	355	357	358	359	360	361	362	363	386	388
585	0	0	1280	1280
4691	1280	640	640	640
4692	1920	640	640	640
4689	1280	0	640	640	8	9	10	11	12	23	63	64	66	67	68	69	70	71	72	73	74	75	76	77	78	164	165	166	167	168	169	170	171	208	209	210	211	212	213	214	215	216	217	218	219	220	282	283	319	320	321	352	353	356	387
4690	1920	0	640	640	14	15	78	79	80	81	82	83	84	85	86	87	88	89	90	91	92	93	94	95	96	171	172	173	174	175	219	220	221	222	223	224	225	226	227	228	229	230	231	232	233	234	289	318	328	329	330	351
586	1280	0	1280	1280
73	0	0	2560	2560
595	2560	1280	1280	1280
596	3840	1280	1280	1280
4747	2560	640	640	640
4748	3200	640	640	640
4745	2560	0	640	640	16	17	95	96	97	98	99	100	101	102	103	104	105	106	107	108	109	110	111	112	113	176	177	178	179	180	181	235	236	237	238	239	240	241	242	243	284	285	286	289	290	291	292	315	316	317	331	332	333	348	349	350	366	367	368	369	370	371	372	373	374	375	376	377	378	379	380	381	382	383	384	385
4746	3200	0	640	640	16	110	114	115	116	117	118	119	120	121	122	123	124	125	126	127	128	129	130	181	182	183	184	185	186	187	188	189	242	243	244	245	246	247	248	249	250	251	252	253	254	255	256	257	313	314	315
593	2560	0	1280	1280
4755	3840	640	640	640
4756	4480	640	640	640
4753	3840	0	640	640	127	129	130	131	132	133	134	135	136	137	138	141	190	191	192	257	258	259	260	261	262	263	264	265	266	267	293	294	295	296	297	298	299	300	301	302	303	304	305	306	307	308	309	312	334	335	336	337	338	339	340	341
4754	4480	0	640	640	18	19	139	140	141	142	143	144	145	146	147	148	149	150	151	152	153	154	155	156	157	193	194	195	196	197	266	267	268	269	270	271	272	273	274	275	276	277	278	279	287	288	304	305	306	307	308	309	310	311	340	341	342	343	344	345	346	347
594	3840	0	1280	1280
74	2560	0	2560	2560
9	0	0	5120	5120
83	5120	2560	2560	2560
84	7680	2560	2560	2560
651	5120	1280	1280	1280
652	6400	1280	1280	1280
5195	5120	640	640	640
5196	5760	640	640	640
5193	5120	0	640	640	288
5194	5760	0	640	640
649	5120	0	1280	1280
650	6400	0	1280	1280
81	5120	0	2560	2560
82	7680	0	2560	2560
10	5120	0	5120	5120
1	0	0	10240	10240
