0		0		0		4096		4096		
1		0		0		2048		2048		
2		2048		0		2048		2048		
3		0		2048		2048		2048		
31		0		2048		1024		1024		
311		0		2048		512		512		
312		512		2048		512		512		
313		0		2560		512		512		
3131		0		2560		256		256		653		572		571		16		17		12		13		8		9		4		5		0		1		
3132		256		2560		256		256		24		25		571		652		
3133		0		2816		256		256		132		133		92		93		85		545		77		78		56		57		58		59		60		61		62		63		
3134		256		2816		256		256		629		630		64		65		66		67		68		69		
314		512		2560		512		512		
3141		512		2560		256		256		26		27		28		29		30		31		32		33		650		648		649		
3142		768		2560		256		256		34		35		36		37		38		39		40		41		651		646		647		
3143		512		2816		256		256		626		94		95		96		97		98		99		100		101		628		
3144		768		2816		256		256		625		624		102		103		104		105		106		107		108		109		641		
32		1024		2048		1024		1024		
321		1024		2048		512		512		
322		1536		2048		512		512		
323		1024		2560		512		512		
3231		1024		2560		256		256		42		43		44		45		46		47		48		49		645		644		
3232		1280		2560		256		256		50		51		52		53		54		55		22		23		20		21		18		19		643		642		14		15		10		11		6		7		2		3		
3233		1024		2816		256		256		110		111		112		113		114		115		116		117		
3234		1280		2816		256		256		118		119		120		121		122		123		124		125		557		86		87		553		79		80		556		75		76		555		73		74		548		70		71		72		
324		1536		2560		512		512		
3241		1536		2560		256		256		
3242		1792		2560		256		256		
3243		1536		2816		256		256		623		126		127		88		89		81		82		
3244		1792		2816		256		256		622		
33		0		3072		1024		1024		
331		0		3072		512		512		
3311		0		3072		256		256		289		290		272		273		202		203		204		205		206		207		208		209		188		189		174		175		168		169		640		136		137		
3312		256		3072		256		256		210		211		212		213		214		215		216		217		190		191		551		638		639		552		170		171		138		139		
3313		0		3328		256		256		
3314		256		3328		256		256		
332		512		3072		512		512		
3321		512		3072		256		256		218		219		220		221		222		223		224		225		627		636		637		626		
3322		768		3072		256		256		291		292		274		275		226		227		228		229		230		231		232		233		635		634		625		624		
3323		512		3328		256		256		
3324		768		3328		256		256		
333		0		3584		512		512		
334		512		3584		512		512		
34		1024		3072		1024		1024		
341		1024		3072		512		512		
3411		1024		3072		256		256		293		294		295		296		297		298		299		300		633		632		
3412		1280		3072		256		256		301		302		303		304		305		306		307		308		276		277		278		279		280		281		234		235		236		237		238		239		192		193		194		195		196		197		631		176		177		178		179		
3413		1024		3328		256		256		
3414		1280		3328		256		256		
342		1536		3072		512		512		
3421		1536		3072		256		256		309		310		559		282		283		558		284		285		240		241		198		199		612		180		181		182		183		623		140		141		142		143		
3422		1792		3072		256		256		286		546		242		243		607		613		144		145		146		147		148		149		150		151		
3423		1536		3328		256		256		433		434		414		415		400		401		334		335		336		337		338		339		340		341		330		331		322		323		324		325		318		319		550		601		313		314		560		
3424		1792		3328		256		256		342		343		344		345		346		347		348		349		603		600		599		
343		1024		3584		512		512		
344		1536		3584		512		512		
3441		1536		3584		256		256		475		476		463		464		447		448		
3442		1792		3584		256		256		
3443		1536		3840		256		256		
3444		1792		3840		256		256		
4		2048		2048		2048		2048		
41		2048		2048		1024		1024		
411		2048		2048		512		512		
412		2560		2048		512		512		
413		2048		2560		512		512		
4131		2048		2560		256		256		
4132		2304		2560		256		256		
4133		2048		2816		256		256		621		
4134		2304		2816		256		256		620		
414		2560		2560		512		512		
4141		2560		2560		256		256		
4142		2816		2560		256		256		
4143		2560		2816		256		256		606		128		129		618		619		
4144		2816		2816		256		256		134		135		604		130		131		90		91		617		83		84		
42		3072		2048		1024		1024		
43		2048		3072		1024		1024		
431		2048		3072		512		512		
4311		2048		3072		256		256		608		244		245		246		247		248		249		609		614		152		153		610		
4312		2304		3072		256		256		250		251		252		253		254		255		605		615		154		155		611		
4313		2048		3328		256		256		350		351		352		353		354		355		598		326		327		597		
4314		2304		3328		256		256		356		357		358		359		360		361		362		363		595		596		
432		2560		3072		512		512		
4321		2560		3072		256		256		256		257		258		259		260		261		262		263		184		185		156		157		158		159		
4322		2816		3072		256		256		311		312		287		288		264		265		266		267		268		269		270		271		200		201		186		187		616		172		173		160		161		162		163		164		165		166		167		
4323		2560		3328		256		256		364		365		366		367		368		369		370		371		602		593		594		
4324		2816		3328		256		256		435		436		416		417		402		403		372		373		374		375		376		377		378		379		592		591		
433		2048		3584		512		512		
434		2560		3584		512		512		
4341		2560		3584		256		256		
4342		2816		3584		256		256		477		478		465		466		449		450		
4343		2560		3840		256		256		
4344		2816		3840		256		256		
44		3072		3072		1024		1024		
441		3072		3072		512		512		
4411		3072		3072		256		256		587		
4412		3328		3072		256		256		
4413		3072		3328		256		256		437		418		419		420		404		380		381		382		383		590		588		315		587		
4414		3328		3328		256		256		438		439		440		441		421		422		423		424		405		406		407		408		384		385		386		387		388		389		589		585		586		
442		3584		3072		512		512		
4421		3584		3072		256		256		
4422		3840		3072		256		256		
4423		3584		3328		256		256		442		443		444		580		425		426		427		428		429		409		410		411		390		391		392		393		579		584		583		
4424		3840		3328		256		256		561		445		446		547		430		431		432		412		413		394		395		396		397		398		399		332		333		328		329		320		321		581		582		316		317		
443		3072		3584		512		512		
4431		3072		3584		256		256		479		467		451		
4432		3328		3584		256		256		480		481		482		483		468		469		470		471		452		453		454		455		
4433		3072		3840		256		256		
4434		3328		3840		256		256		
444		3584		3584		512		512		
4441		3584		3584		256		256		496		497		567		493		554		490		566		578		487		484		472		456		457		458		459		460		580		
4442		3840		3584		256		256		498		499		575		494		495		491		492		577		565		488		489		564		485		486		563		473		474		562		461		462		
4443		3584		3840		256		256		529		530		531		532		533		534		535		536		570		574		576		516		517		512		513		500		501		502		503		504		505		506		507		
4444		3840		3840		256		256		537		538		539		540		541		542		543		544		527		528		569		525		526		568		523		524		573		549		518		519		520		521		522		514		515		508		509		510		511		
