184  
45  128
0  0  1  1  1  1  2  3  1  1  1  1  4  5  6  7  6  7  8  9  10  11  8  9  12  13  8  9  12  13  8  9  12  13  8  9  12  13  8  9  12  13  8  9  14  15  0  0  16  16  16  16  16  16  16  16  16  16  16  16  16  16  16  16  16  16  16  16  16  16  16  16  16  16  16  16  16  16  16  16  16  16  16  16  16  16  16  16  16  16  16  16  16  16  16  16  16  16  16  16  16  16  16  16  16  16  16  16  16  16  16  16  16  16  16  16  16  16  16  16  16  16  16  16  16  16  16  16  
0  0  1  1  17  18  19  19  17  18  1  1  4  5  20  21  20  21  22  23  24  25  22  23  26  27  22  23  26  27  22  23  26  27  22  23  26  27  22  23  26  27  22  23  28  28  0  0  16  16  16  16  16  16  16  16  16  16  16  16  16  16  16  16  16  16  16  16  16  16  16  16  16  16  16  16  16  16  16  16  16  16  16  16  16  16  16  16  16  16  16  16  16  16  16  16  16  16  16  16  16  16  16  16  16  16  16  16  16  16  16  16  16  16  16  16  16  16  16  16  16  16  16  16  16  16  16  16  
0  0  1  1  29  30  19  19  29  30  1  1  4  5  14  15  14  15  31  32  4  5  31  32  4  5  31  32  4  5  31  32  4  5  31  32  4  5  31  32  4  5  31  32  28  28  0  0  16  16  16  16  16  16  16  16  16  16  16  16  16  16  16  16  16  16  16  16  16  16  16  16  16  16  16  16  16  16  16  16  16  16  16  16  16  16  16  16  16  16  16  16  16  16  16  16  16  16  16  16  16  16  16  16  16  16  16  16  16  16  16  16  16  16  16  16  16  16  16  16  16  16  16  16  16  16  16  16  
0  0  17  18  33  34  19  19  33  34  17  18  4  5  28  28  28  28  35  36  4  5  35  36  4  5  35  36  4  5  35  36  4  5  35  36  4  5  35  36  4  5  35  36  28  28  0  0  16  16  16  16  16  16  16  16  16  16  16  16  16  16  16  16  16  16  16  16  16  16  16  16  16  16  16  16  16  16  16  16  16  16  16  16  16  16  16  16  16  16  16  16  16  16  16  16  16  16  16  16  16  16  16  16  16  16  16  16  16  16  16  16  16  16  16  16  16  16  16  16  16  16  16  16  16  16  16  16  
37  38  29  30  33  34  39  39  33  34  29  30  4  5  28  28  28  28  40  41  4  5  40  41  4  5  40  41  4  5  40  41  4  5  40  41  4  5  40  41  4  5  40  41  28  28  0  0  16  16  16  16  16  16  16  16  16  16  16  16  16  16  16  16  16  16  16  16  16  16  16  16  16  16  16  16  16  16  16  16  16  16  16  16  16  16  16  16  16  16  16  16  16  16  16  16  16  16  16  16  16  16  16  16  16  16  16  16  16  16  16  16  16  16  16  16  16  16  16  16  16  16  16  16  16  16  16  16  
42  43  33  34  33  34  1  1  33  34  33  34  4  5  28  28  28  28  44  41  4  5  44  41  4  5  44  41  4  5  44  41  4  5  44  41  4  5  44  41  4  5  44  41  28  28  0  0  16  16  16  16  16  16  16  16  16  16  16  16  16  16  16  16  16  16  16  16  16  16  16  16  16  16  16  16  16  16  16  16  16  16  16  16  16  16  16  16  16  16  16  16  16  16  16  16  16  16  16  16  16  16  16  16  16  16  16  16  16  16  16  16  16  16  16  16  16  16  16  16  16  16  16  16  16  16  16  16  
45  46  47  48  47  48  49  50  47  48  47  48  4  5  51  51  51  51  52  53  54  55  52  53  54  55  52  53  54  55  52  53  54  55  52  53  54  55  52  53  54  55  52  53  28  28  0  0  16  16  16  16  16  16  16  16  16  16  16  16  16  16  16  16  16  16  16  16  16  16  16  16  16  16  16  16  16  16  16  16  16  16  16  16  16  16  16  16  16  16  16  16  16  16  16  16  16  16  16  16  16  16  16  16  16  16  16  16  16  16  16  16  16  16  16  16  16  16  16  16  16  16  16  16  16  16  16  16  
56  57  58  59  58  59  60  61  58  59  58  59  54  55  62  62  63  63  63  63  63  63  63  63  63  63  63  63  63  63  63  63  63  63  63  63  63  63  63  63  63  63  63  63  51  51  0  0  16  16  16  16  16  16  16  16  16  16  16  16  16  16  16  16  16  16  16  16  16  16  16  16  16  16  16  16  16  16  16  16  16  16  16  16  16  16  16  16  16  16  16  16  16  16  16  16  16  16  16  16  16  16  16  16  16  16  16  16  16  16  16  16  16  16  16  16  16  16  16  16  16  16  16  16  16  16  16  16  
64  64  64  64  64  64  64  64  64  64  64  64  64  64  65  65  65  65  66  67  68  68  66  67  68  68  66  67  68  68  66  67  68  68  66  67  68  68  66  67  68  68  28  69  70  63  0  0  16  16  16  16  16  16  16  16  16  16  16  16  16  16  16  16  16  16  16  16  16  16  16  16  16  16  16  16  16  16  16  16  16  16  16  16  16  16  16  16  16  16  16  16  16  16  16  16  16  16  16  16  16  16  16  16  16  16  16  16  16  16  16  16  16  16  16  16  16  16  16  16  16  16  16  16  16  16  16  16  
20  21  20  21  20  21  20  21  20  21  20  21  20  21  20  21  20  21  22  23  26  27  22  23  26  27  22  23  26  27  22  23  26  27  22  23  26  27  22  23  26  27  71  72  28  28  0  0  16  16  16  16  16  16  16  16  16  16  16  16  16  16  16  16  16  16  16  16  16  16  16  16  16  16  16  16  16  16  16  16  16  16  16  16  16  16  16  16  16  16  16  16  16  16  16  16  16  16  16  16  16  16  16  16  16  16  16  16  16  16  16  16  16  16  16  16  16  16  16  16  16  16  16  16  16  16  16  16  
73  74  73  74  73  74  73  74  73  74  73  74  73  74  73  74  73  74  1  1  54  55  1  1  54  55  1  1  54  55  1  1  54  55  1  1  54  55  1  1  54  55  75  51  51  51  0  0  76  76  77  78  79  80  77  78  81  81  77  78  79  80  77  78  82  83  81  81  81  81  84  85  81  81  77  78  79  80  77  78  81  81  77  78  81  81  77  78  81  81  77  78  79  80  76  76  16  16  16  16  16  16  16  16  16  16  16  16  16  16  16  16  16  16  16  16  16  16  16  16  16  16  16  16  16  16  16  16  
0  0  8  9  12  13  8  9  12  13  8  9  12  13  8  9  86  87  1  1  4  5  1  1  4  5  1  1  4  5  1  1  4  5  1  1  4  5  1  1  28  69  88  87  89  90  0  0  0  0  4  5  91  92  4  5  93  94  4  5  91  92  4  5  95  96  28  28  28  28  97  98  93  94  4  5  99  100  4  5  28  28  4  5  28  28  4  5  93  94  4  5  101  102  0  0  16  16  16  16  16  16  16  16  16  16  16  16  16  16  16  16  16  16  16  16  16  16  16  16  16  16  16  16  16  16  16  16  
0  0  22  23  26  27  22  23  26  27  22  23  26  27  22  23  95  103  1  1  54  55  1  1  54  55  1  1  54  55  1  1  54  55  1  1  54  55  1  1  104  75  95  103  105  106  0  0  0  0  4  5  28  28  4  5  107  108  4  5  28  28  4  5  109  110  28  28  28  28  28  28  107  108  4  5  109  110  4  5  28  28  4  5  28  28  54  55  107  108  4  5  111  112  0  0  16  16  16  16  16  16  16  16  16  16  16  16  16  16  16  16  16  16  16  16  16  16  16  16  16  16  16  16  16  16  16  16  
0  0  113  113  4  5  113  113  4  5  113  113  4  5  1  1  63  63  114  115  116  116  114  115  116  116  114  115  116  116  114  115  116  116  114  115  116  116  114  115  117  118  63  63  63  63  0  119  37  38  4  5  89  90  4  5  101  102  4  5  89  90  4  5  97  98  28  28  93  94  89  90  91  92  4  5  120  121  4  5  89  90  4  5  93  94  117  118  122  102  4  5  123  124  0  0  16  16  16  16  16  16  16  16  16  16  16  16  16  16  16  16  16  16  16  16  16  16  16  16  16  16  16  16  16  16  16  16  
0  0  125  125  4  5  125  125  4  5  125  125  4  5  1  1  28  28  22  23  26  27  22  23  26  27  22  23  26  27  22  23  26  27  22  23  26  27  22  23  4  5  28  28  28  28  109  110  42  43  4  5  105  106  54  55  105  106  54  55  105  106  54  55  28  28  28  28  107  108  105  106  28  28  4  5  111  112  54  55  105  106  54  55  107  108  4  5  105  106  54  55  95  103  0  0  16  16  16  16  16  16  16  16  16  16  16  16  16  16  16  16  16  16  16  16  16  16  16  16  16  16  16  16  16  16  16  16  
0  0  125  125  4  5  125  125  4  5  125  126  54  55  63  63  89  90  1  1  4  5  1  1  4  5  1  1  4  5  1  1  4  5  113  113  4  5  113  113  4  5  28  28  86  87  120  121  45  46  4  5  0  119  116  116  114  115  116  116  114  115  116  116  28  28  28  28  91  92  116  116  89  90  4  127  128  129  116  116  114  115  117  118  130  131  4  127  114  115  116  116  114  115  0  0  16  16  16  16  16  16  16  16  16  16  16  16  16  16  16  16  16  16  16  16  16  16  16  16  16  16  16  16  16  16  16  16  
0  0  125  125  4  5  125  125  4  5  132  133  63  63  28  28  111  112  1  1  4  5  1  1  4  5  1  1  4  5  1  1  4  5  125  125  4  5  125  125  4  5  28  28  95  103  105  106  56  57  54  55  109  110  26  27  22  23  26  27  22  23  26  27  28  28  28  28  28  28  26  27  111  112  24  25  22  23  26  27  22  23  4  5  95  103  24  25  22  23  26  27  22  23  0  0  16  16  16  16  16  16  16  16  16  16  16  16  16  16  16  16  16  16  16  16  16  16  16  16  16  16  16  16  16  16  16  16  
0  0  125  125  4  5  125  125  54  55  134  87  89  90  89  90  123  124  1  1  4  5  1  1  4  5  1  1  4  5  1  1  4  5  125  125  4  5  125  125  4  5  51  51  0  0  0  0  0  0  117  135  136  137  4  5  138  138  4  5  138  138  4  5  86  87  93  94  89  90  4  5  95  103  4  5  139  140  4  5  141  142  4  5  143  38  4  5  141  142  4  5  141  142  0  0  16  16  16  16  16  16  16  16  16  16  16  16  16  16  16  16  16  16  16  16  16  16  16  16  16  16  16  16  16  16  16  16  
0  0  58  59  54  55  58  59  0  0  95  103  105  106  105  106  95  103  1  1  54  55  1  1  54  55  1  1  54  55  1  1  4  5  125  125  4  5  125  125  4  5  0  0  0  0  0  0  0  0  24  25  107  108  4  5  28  28  4  5  28  28  54  55  95  103  107  108  105  106  54  55  144  145  54  55  95  103  54  55  105  106  54  55  105  106  54  55  105  106  54  55  105  106  0  0  16  16  16  16  16  16  16  16  16  16  16  16  16  16  16  16  16  16  16  16  16  16  16  16  16  16  16  16  16  16  16  16  
0  0  64  64  64  64  64  64  64  64  64  64  64  64  64  64  64  64  64  64  64  64  64  64  64  64  64  64  64  64  0  0  4  5  125  125  4  5  125  125  4  5  0  0  0  0  0  0  0  0  4  5  91  146  54  55  51  147  54  55  66  67  116  116  114  115  99  148  114  115  116  116  149  150  116  116  114  115  116  116  114  115  116  116  114  115  116  116  114  115  116  116  114  115  0  0  16  16  16  16  16  16  16  16  16  16  16  16  16  16  16  16  16  16  16  16  16  16  16  16  16  16  16  16  16  16  16  16  
0  0  20  21  20  21  20  21  20  21  20  21  20  21  20  21  20  21  20  21  20  21  20  21  20  21  20  21  20  21  0  0  54  55  58  59  54  55  58  59  54  55  0  0  0  0  0  0  0  0  4  5  71  72  117  135  109  110  117  135  22  23  26  27  22  23  1  1  22  23  26  27  1  1  26  27  22  23  26  27  22  23  26  27  22  23  26  27  22  23  26  27  22  23  0  0  16  16  16  16  16  16  16  16  16  16  16  16  16  16  16  16  16  16  16  16  16  16  16  16  16  16  16  16  16  16  16  16  
0  0  73  74  73  74  73  74  73  74  73  74  73  74  73  74  73  74  73  74  73  74  73  74  73  74  73  74  73  74  0  0  0  0  0  0  0  0  0  0  0  0  0  0  0  0  0  0  0  0  4  5  151  28  24  152  97  98  24  152  138  138  4  5  138  138  153  154  138  138  155  156  138  138  4  5  157  158  4  5  138  138  4  5  138  138  4  5  138  138  4  5  138  138  117  118  76  81  79  80  84  85  77  78  81  81  84  85  79  80  81  81  77  78  81  81  79  80  77  78  81  81  81  81  79  80  76  76  
1  1  1  1  1  1  1  1  1  1  1  1  1  1  1  1  1  1  1  1  1  1  1  1  1  1  1  1  1  1  1  1  1  1  1  1  1  1  1  1  1  1  1  1  1  1  1  1  0  0  4  5  72  28  4  5  28  28  4  5  89  90  4  5  28  28  4  5  28  28  28  28  93  94  4  5  91  92  4  5  28  28  4  5  28  28  4  5  28  28  4  5  28  28  4  5  37  90  99  100  97  98  4  5  89  90  159  160  91  92  28  28  4  5  93  94  91  92  4  5  89  90  93  94  91  92  0  0  
1  1  1  1  1  1  1  1  1  1  1  1  1  1  1  1  1  1  1  1  1  1  1  1  1  1  1  1  1  1  1  1  1  1  1  1  1  1  1  1  1  1  1  1  1  1  1  1  0  0  54  161  28  28  4  5  28  28  4  5  111  112  4  5  28  28  54  55  28  28  28  28  107  108  4  5  28  28  4  5  28  28  4  5  28  28  4  5  28  28  4  5  28  28  4  5  42  43  109  110  28  28  4  5  111  112  107  108  28  28  28  28  4  5  107  108  28  28  4  5  111  112  107  108  28  28  0  0  
1  1  1  1  1  1  1  1  1  1  1  1  1  1  1  1  1  1  1  1  1  1  1  1  1  1  1  1  1  1  1  1  1  1  1  1  1  1  1  1  1  1  1  1  1  1  1  1  0  0  117  118  89  90  4  5  89  90  4  5  123  124  4  5  89  90  117  118  89  90  86  87  130  131  4  5  89  90  4  5  89  90  4  5  86  87  4  5  86  87  4  5  89  90  4  5  45  46  97  98  93  94  4  5  123  124  91  92  89  90  89  90  4  5  99  100  28  28  4  5  123  124  101  102  28  28  0  0  
1  1  1  1  1  1  1  1  1  1  1  1  1  1  1  1  1  1  1  1  1  1  1  1  1  1  1  1  1  1  1  1  1  1  1  1  1  1  1  1  1  1  1  1  1  1  1  1  0  0  54  55  105  106  54  55  105  106  54  55  95  103  54  55  105  106  4  5  105  106  95  103  95  103  54  55  105  106  54  55  105  106  54  55  95  103  54  55  95  103  54  55  105  106  54  55  56  57  28  28  107  108  54  55  95  103  28  28  105  106  105  106  54  55  109  110  28  28  54  55  95  103  105  106  28  28  0  0  
1  1  1  1  1  1  1  1  1  1  1  1  1  1  1  1  1  1  1  1  1  1  1  1  1  1  1  1  1  1  1  1  1  1  1  1  1  1  1  1  1  1  1  1  1  1  1  1  0  0  117  118  114  115  116  116  114  115  116  116  114  115  116  116  114  115  162  163  114  115  116  116  114  115  116  116  114  115  116  116  114  115  116  116  114  115  116  116  114  115  116  116  114  115  0  0  0  63  28  28  130  131  117  118  0  0  28  28  63  63  0  0  0  63  120  121  89  90  0  0  0  119  143  38  28  28  0  0  
1  1  1  1  1  1  1  1  1  1  1  1  1  1  1  1  1  1  1  1  1  1  1  1  1  1  1  1  1  1  1  1  1  1  1  1  1  1  1  1  1  1  1  1  1  1  1  1  0  0  4  5  22  23  26  27  22  23  26  27  22  23  26  27  22  23  26  27  22  23  26  27  22  23  26  27  22  23  26  27  22  23  26  27  22  23  26  27  22  23  26  27  22  23  0  0  0  28  28  28  95  103  4  5  0  0  28  28  28  28  0  0  0  28  105  106  111  112  0  0  109  110  111  112  51  51  0  0  
1  1  1  1  1  1  1  1  1  1  1  1  1  1  1  1  1  1  1  1  1  1  1  1  1  1  1  1  1  1  1  1  1  1  1  1  1  1  1  1  1  1  1  1  1  1  1  1  0  0  4  5  164  165  4  5  164  165  4  5  164  165  4  5  164  165  4  5  164  165  4  5  164  165  4  5  164  165  4  5  164  165  4  5  164  165  4  5  164  165  4  5  164  165  0  0  0  28  93  94  0  119  4  5  0  0  28  28  93  94  0  0  0  28  63  63  123  124  0  0  97  98  166  167  168  118  0  0  
1  1  1  1  1  1  1  1  1  1  1  1  1  1  1  1  1  1  1  1  1  1  1  1  1  1  1  1  1  1  1  1  1  1  1  1  1  1  1  1  1  1  1  1  1  1  1  1  0  0  4  5  107  108  4  5  107  108  4  5  107  108  4  5  107  108  4  5  107  108  4  5  107  108  4  5  107  108  4  5  107  108  4  5  107  108  4  5  107  108  4  5  107  108  0  0  0  28  107  108  109  110  4  5  0  0  28  28  107  108  0  0  0  28  28  28  95  103  0  0  28  28  71  72  4  5  0  0  
1  1  1  1  1  1  1  1  1  1  1  1  1  1  1  1  1  1  1  1  1  1  1  1  1  1  1  1  1  1  1  1  1  1  1  1  1  1  1  1  1  1  1  1  1  1  1  1  0  0  4  5  99  100  4  5  91  92  4  5  99  100  4  5  99  100  4  5  101  102  4  5  91  92  4  5  99  100  4  5  91  92  4  5  99  100  4  5  91  92  4  5  99  100  0  0  0  28  101  102  97  98  4  5  0  0  28  28  91  92  0  0  0  28  28  28  63  63  63  63  28  69  72  28  4  5  0  0  
1  1  1  1  1  1  1  1  1  1  1  1  1  1  1  1  1  1  1  1  1  1  1  1  1  1  1  1  1  1  1  1  1  1  1  1  1  1  1  1  1  1  1  1  1  1  1  1  0  0  4  5  109  110  4  5  28  28  4  5  109  110  4  5  109  110  4  5  111  112  4  5  28  28  4  5  109  110  4  5  28  28  4  5  109  110  4  5  28  28  4  5  109  110  0  0  0  28  111  112  28  28  4  5  0  0  28  28  28  28  0  0  0  28  28  28  28  28  28  28  71  72  28  28  4  5  0  0  
1  1  1  1  1  1  1  1  1  1  1  1  1  1  1  1  1  1  1  1  1  1  1  1  1  1  1  1  1  1  1  1  1  1  1  1  1  1  1  1  1  1  1  1  1  1  1  1  0  0  169  170  171  172  169  170  51  51  169  170  171  172  169  170  171  172  169  170  173  174  169  170  51  51  169  170  171  172  169  170  51  51  169  170  171  172  169  170  51  51  169  170  171  172  0  0  0  51  173  174  51  51  169  170  0  0  51  51  51  51  0  0  0  28  175  176  28  28  28  28  177  28  86  87  178  179  0  0  
1  1  1  1  1  1  1  1  1  1  1  1  1  1  1  1  1  1  1  1  1  1  1  1  1  1  1  1  1  1  1  1  1  1  1  1  1  1  1  1  1  1  1  1  1  1  1  1  1  1  1  1  1  1  1  1  1  1  1  1  1  1  1  1  1  1  1  1  1  1  1  1  1  1  1  1  1  1  1  1  1  1  1  1  1  1  1  1  1  1  1  1  1  1  1  1  1  1  1  1  1  1  1  1  1  1  1  1  1  1  1  1  0  28  4  5  28  28  28  69  72  28  95  96  4  5  0  0  
1  1  1  1  1  1  1  1  1  1  1  1  1  1  1  1  1  1  1  1  1  1  1  1  1  1  1  1  1  1  1  1  1  1  1  1  1  1  1  1  1  1  1  1  1  1  1  1  1  1  1  1  1  1  1  1  1  1  1  1  1  1  1  1  1  1  1  1  1  1  1  1  1  1  1  1  1  1  1  1  1  1  1  1  1  1  1  1  1  1  1  1  1  1  1  1  1  1  1  1  1  1  1  1  1  1  1  1  1  1  1  1  0  28  4  5  28  28  71  72  28  28  109  110  4  5  0  0  
1  1  1  1  1  1  1  1  1  1  1  1  1  1  1  1  1  1  1  1  1  1  1  1  1  1  1  1  1  1  1  1  1  1  1  1  1  1  1  1  1  1  1  1  1  1  1  1  1  1  1  1  1  1  1  1  1  1  1  1  1  1  1  1  1  1  1  1  1  1  1  1  1  1  1  1  1  1  1  1  1  1  1  1  1  1  1  1  1  1  1  1  1  1  1  1  1  1  1  1  1  1  1  1  1  1  1  1  1  1  1  1  0  51  4  5  28  69  88  87  89  90  97  98  4  5  0  0  
1  1  1  1  1  1  1  1  1  1  1  1  1  1  1  1  1  1  1  1  1  1  1  1  1  1  1  1  1  1  1  1  1  1  1  1  1  1  1  1  1  1  1  1  1  1  1  1  1  1  1  1  1  1  1  1  1  1  1  1  1  1  1  1  1  1  1  1  1  1  1  1  1  1  1  1  1  1  1  1  1  1  1  1  1  1  1  1  1  1  1  1  1  1  1  1  1  1  1  1  1  1  1  1  1  1  1  1  1  1  1  1  0  0  54  55  104  75  95  103  105  106  28  28  4  5  0  0  
1  1  1  1  1  1  1  1  1  1  1  1  1  1  1  1  1  1  1  1  1  1  1  1  1  1  1  1  1  1  1  1  1  1  1  1  1  1  1  1  1  1  1  1  1  1  1  1  1  1  1  1  1  1  1  1  1  1  1  1  1  1  1  1  1  1  1  1  1  1  1  1  1  1  1  1  1  1  1  1  1  1  1  1  1  1  1  1  1  1  1  1  1  1  1  1  1  1  1  1  1  1  1  1  1  1  1  1  1  1  1  1  0  0  117  118  0  119  63  63  63  63  28  28  4  5  0  0  
1  1  1  1  1  1  1  1  1  1  1  1  1  1  1  1  1  1  1  1  1  1  1  1  1  1  1  1  1  1  1  1  1  1  1  1  1  1  1  1  1  1  1  1  1  1  1  1  1  1  1  1  1  1  1  1  1  1  1  1  1  1  1  1  1  1  1  1  1  1  1  1  1  1  1  1  1  1  1  1  1  1  1  1  1  1  1  1  1  1  1  1  1  1  1  1  1  1  1  1  1  1  1  1  1  1  1  1  1  1  1  1  0  0  4  5  109  110  28  28  28  28  51  51  54  55  0  0  
1  1  1  1  1  1  1  1  1  1  1  1  1  1  1  1  1  1  1  1  1  1  1  1  1  1  1  1  1  1  1  1  1  1  1  1  1  1  1  1  1  1  1  1  1  1  1  1  1  1  1  1  1  1  1  1  1  1  1  1  1  1  1  1  1  1  1  1  1  1  1  1  1  1  1  1  1  1  1  1  1  1  1  1  1  1  1  1  1  1  1  1  1  1  1  1  1  1  1  1  1  1  1  1  1  1  1  1  1  1  1  1  37  38  4  5  97  98  28  28  28  69  70  63  143  38  0  0  
1  1  1  1  1  1  1  1  1  1  1  1  1  1  1  1  1  1  1  1  1  1  1  1  1  1  1  1  1  1  1  1  1  1  1  1  1  1  1  1  1  1  1  1  1  1  1  1  1  1  1  1  1  1  1  1  1  1  1  1  1  1  1  1  1  1  1  1  1  1  1  1  1  1  1  1  1  1  1  1  1  1  1  1  1  1  1  1  1  1  1  1  1  1  1  1  1  1  1  1  1  1  1  1  1  1  1  1  1  1  1  1  42  43  4  5  28  28  28  28  71  72  28  28  111  112  0  0  
1  1  1  1  1  1  1  1  1  1  1  1  1  1  1  1  1  1  1  1  1  1  1  1  1  1  1  1  1  1  1  1  1  1  1  1  1  1  1  1  1  1  1  1  1  1  1  1  1  1  1  1  1  1  1  1  1  1  1  1  1  1  1  1  1  1  1  1  1  1  1  1  1  1  1  1  1  1  1  1  1  1  1  1  1  1  1  1  1  1  1  1  1  1  1  1  1  1  1  1  1  1  1  1  1  1  1  1  1  180  181  182  45  46  4  5  86  87  28  69  183  90  89  90  123  124  0  0  
1  1  1  1  1  1  1  1  1  1  1  1  1  1  1  1  1  1  1  1  1  1  1  1  1  1  1  1  1  1  1  1  1  1  1  1  1  1  1  1  1  1  1  1  1  1  1  1  1  1  1  1  1  1  1  1  1  1  1  1  1  1  1  1  1  1  1  1  1  1  1  1  1  1  1  1  1  1  1  1  1  1  1  1  1  1  1  1  1  1  1  1  1  1  1  1  1  1  1  1  1  1  1  1  1  1  1  1  1  1  1  1  56  57  54  55  95  103  104  75  105  106  105  106  95  103  0  0  
1  1  1  1  1  1  1  1  1  1  1  1  1  1  1  1  1  1  1  1  1  1  1  1  1  1  1  1  1  1  1  1  1  1  1  1  1  1  1  1  1  1  1  1  1  1  1  1  1  1  1  1  1  1  1  1  1  1  1  1  1  1  1  1  1  1  1  1  1  1  1  1  1  1  1  1  1  1  1  1  1  1  1  1  1  1  1  1  1  1  1  1  1  1  1  1  1  1  1  1  1  1  1  1  1  1  1  1  1  1  1  1  0  0  0  0  0  0  0  0  0  0  0  0  0  0  0  0  
